#########
#       #
#   s   #
#       #
#   c   #
#   c   #
#   c   #
#       #
#   e   #
#       #
#       #
#   e   #
#       #
#       #
#########